10000100001
00000000000
00000000000
00100001000
00000000000
00000000000
10000100001