10001000000
00101000000
00101010000
00100010000
00101010000
00101000000
10001000000